12 12
111111111111
122222222121
122222322121
122222222221
121111211121
122212222221
122214222221
122212122221
121222122221
131111113111
122222222221
111111111111