12 12
111111111111
122222222221
122222322221
122222222221
122222222221
122222222221
122224222221
122222222221
122222222221
132222223221
122222222221
111111111111